NO stone wall.xpm
SO stone wall.xpm
WE stone wall.xpm
EA stone wall.xpm

F 220,180,0
C 225,30,0

11111111111111111111111111
10000000001110000000000011
10110000011100000000000011
10010000001000000000000011
10000000001000000000000011
10E00000000000000000001111
11111111111111111111111111

        11111111111111111111111111
        100110000000000001
11111111011111111000000011111111
10010000011000000000000001
11111111101100000111111111
100000000011000001110111111111111
110111111111011100000010001
0111111111011101010010001111
1100000011010101100000010001
10000000000000001100010001
1000000000000001101010010001
110000011101010111110111100111
11110111 1110101 101111010001
11111111 1111111 111111111111
