NO stone_wall.xpm
SO stone_wall.xpm
WE stone_wall.xpm
EA stone_wall.xpm
         
F 220,180,0
C 225,30,0

		1111111111111111111111111
		1000000000110000000000001
		10110000011111111000000011111111
		1001000001      1000000000000001
1111111110110000011111111000000011111111
100000000011000001110111111111111
11110111111111011100000010001
11110111111111011101010010001
11000000110101011100000010001
10000000000000001100000010001
10000000000000001101010010001
11000001110101011111011110N0111
11110111 1110101 101111010001
11111111 1111111 111111111111
