NO ./wall_texture.png
SO ./wooden_wall.png
WE ./wooden_wall.png
EA ./wooden_wall.png

F 220,180,0
C 0,255,0


111111111111111111111111111111
111111111111111111111110001111
100000000011100000000000000011
101100000111000000000000011001
100100000010000000000000001001
100000000010000000000001110001
100000000000000W00001110111111
100000000010000001010001110001
100000000010000001010001110001
100001111110000001010000000011
100000000000001111000000000011
100000000000000000010000000001
100000000000000000000000000001
111111111111111111111111111111


