NO stone wall.xpm
SO stone wall.xpm
WE stone wall.xpm
EA stone wall.xpm

F 220,180,0
C 225,30,0

11111111111111111111111111
10000N00000110000000000011
10110000011100000000000011
10010000000000000000000011
11111111111111111111111111
