NO stone wall.xpm
SO stone wall.xpm
WE stone wall.xpm
EA stone wall.xpm

F 220,180,0
C 225,30,0

        11111111111111111111111111
        100110000000000001
11111111011111111000000011111111
10010000011000000000000001
11111111101100000111111111
100000000011000001110111111111111
11110111111111011100000010001
11110111111111011101010010001
11000000110101011100000010001
10000000000000001100000010001
10000000000000001101010010001
110000011101010111110111100111
11110111 1110101 101111010001
11111111 1111111 111111111111


11111111111111111111111111
10000N00000110000000000011
10110000011100000000000011
10010000000000000000000011
11111111111111111111111111
