NO stone wall.xpm
SO stone wall.xpm
WE stone wall.xpm
EA stone wall.xpm

F 220,180,0
C 225,30,0


11111111111111111111111111111
11111111111111111111111111111
10000000001110000000000000111
10110000011100000000001100111
10010000001000000000000100111
10000000001000000000000000111
10000000000000000N00001111111
10000000001000000101000000111
10000000001000000101000000111
10000111111000000101000000111
10000000000000111100000000111
10000000000000000001000000111
10000000000000000000000000111
11111111111111111111111111111

