NO stone wall.xpm
SO stone wall.xpm
WE stone wall.xpm
EA stone wall.xpm

F 220,180,0
C 225,30,0

11111111111111111111111111
10000000001110000000000011
10110000011100000000000011
10010000001000000000000011
10000000001000000000000011
10E00000000000000000001111
11111111111111111111111111
