EA ./textures/wood.png
NO ./textures/redbrick.png
SO ./textures/wood.png
WE ./textures/redbrick.png

F 160,,120,,60
C 135,206,235

			 		 				
111111111111111111111111111111
111111111111111111111110001111
100000000011100000000000000011
101100000111000000000000011001
100100000010000000000000001001
100000000010000000000001110001
100000000000000N00001110111111
10000000001000000101000111001
10000000001000000101001110001
100001111110000001010000000011
100000000010000000000001110001
100000000000000000000000000001
10000000000000000000011011111
111111111111111111111111111111
 
