NO ./textures/wall_texture.png
SO ./textures/redbrick.png
WE ./textures/wall_texture.png
EA ./textures/redbrick.png
F 150,100,50
C 200,200,255

111111111111111111
100000000011000001
101111111011111101
101000001000000001
101011101111101101
101010100000101101
101010101110101101
101010100010101101
101010111110101101
101010000000101101
101111101111101101
100000101000000001
111111101111111101
100000000000000001
1011111111100111101
101000000000001001
101011101110101101
101010101010101101
101010101010101101
1010101N001010101
111111111111111111
