NO ./textures/wall_texture.png
EA ./textures/redbrick.png
SO ./textures/wall_texture.png
WE ./textures/redbrick.png

F 160,120,60
C 135,206,235


111111111111111111111111111111
10000000001000N00000000111
100000000010000000000011
100000000010000000000001111111
100000000010000000000001111
111111111111111111111111111111
