NO ./textures/ash.png
SO ./textures/picachu.png
WE ./textures/pokeball.png
EA ./textures/charmander.png
F 150,100,50
C 200,200,255

111111111111111111 
1000000000S0000001
101111111011111101
101000001000000001
101011101111101101
100010000000101101
111010111110101101
100010100000101101
101110101111101101
101000101000001101
101011101111101101
100000000000000001
111111101100111111
100000000000000001
101111111011111101
101000000000001001
101000000000001001
101011101110101101
101010101010101101
101010100010101011
111111111111111111
