NO ./textures/ash.png
SO ./textures/picachu.png
WE ./textures/pokeball.png
EA ./textures/charmander.png
F 150,100,50
C 200,200,255

1111111111111111111
1000000000000000011
1011111110111111011
1010000010000000011
1010111011111011011
1000100000001011011
1110101111101011011
1000101000001011011
1011101011111011011
1010001010000011011
1010111011111011011
1000000000000000011
1111111011001111111
1000000000000000011
1011111100011111011
1010000000000010011
1010111011101011011
1010101010101011011
1010101N00101010111
1111111111111111111
1111111111111111111
