NO ./textures/wall_texture.png
SO ./textures/redbrick.png
WE ./textures/wall_texture.png
EA ./textures/redbrick.png
F 300,100,0
C 200,30,0

111111
100001
1010N1
100001
111111
