NO ./textures/redbrick.png
SO ./textures/wall_texture.png
WE ./textures/redbrick.png
EA ./textures/wall_texture.png
F 220,100,0
C 225,30,0

11111
1EN001
101001
110001
111111
