NO ./textures/wall_texture.png
EA ./textures/redbrick.png
SO ./textures/wall_texture.png
WE ./textures/redbrick.png

F 220,100,0
C 225,30,0

111111
1000001
10N0001
1000001
111111

//segmetation fault maybe spaces should be only between 1's